{
  "map": [
    ["W", "W", "W", "R", "O", "C", "M", "B", "G", "1"],
    ["1", "_", "_", "_", "_", "_", "_", "_", "_", "1"],
    ["1", "_", "_", "_", "_", "_", "_", "1", "_", "1"],
    ["1", "_", "_", "_", "_", "_", "_", "_", "_", "1"],
    ["1", "_", "_", "1", "_", "_", "_", "_", "_", "1"],
    ["1", "_", "_", "_", "_", "_", "_", "_", "_", "1"],
    ["1", "_", "_", "_", "_", "_", "_", "_", "_", "1"],
    ["1", "R", "R", "R", "D", "R", "R", "R", "R", "1"],
    ["1", "_", "_", "_", "_", "_", "_", "_", "_", "1"],
    ["1", "_", "_", "_", "_", "_", "_", "_", "_", "1"],
    ["1", "_", "_", "_", "5", "_", "_", "1", "_", "1"],
    ["1", "_", "_", "_", "_", "_", "_", "_", "_", "1"],
    ["1", "_", "_", "1", "_", "3", "_", "_", "_", "1"],
    ["1", "_", "_", "_", "_", "_", "_", "2", "_", "1"],
    ["G", "D", "G", "_", "_", "_", "_", "_", "_", "1"],
    ["1", "_", "G", "_", "4", "_", "3", "_", "_", "1"],
    ["1", "E", "G", "_", "_", "_", "_", "_", "_", "1"],
    ["1", "1", "1", "1", "1", "1", "1", "1", "1", "1"]
  ],
  "player_start": [1.5, 5],
  "inventory": ["Pistol", "Shotgun", "Machine Gun", "Plasma Gun"],
  "starting_ammo": {
    "Pistol": 30,
    "Shotgun": 10,
    "Machine Gun": 50,
    "Plasma Gun": 20
  }
}