{
  "map": [
    ["W", "W", "W", "W", "W", "W", "W", "W", "W", "W"],
    ["W", "_", "_", "_", "_", "_", "_", "_", "_", "W"],
    ["W", "_", "_", "_", "_", "_", "_", "W", "_", "W"],
    ["W", "_", "_", "_", "_", "_", "_", "_", "_", "W"],
    ["W", "_", "_", "W", "_", "_", "_", "_", "_", "W"],
    ["W", "_", "_", "_", "_", "_", "_", "_", "_", "W"],
    ["W", "_", "_", "_", "_", "_", "_", "_", "_", "W"],
    ["W", "W", "W", "W", "D", "W", "W", "W", "W", "W"],
    ["W", "_", "_", "_", "_", "_", "_", "_", "_", "W"],
    ["W", "_", "_", "_", "_", "_", "_", "_", "_", "W"],
    ["W", "_", "_", "_", "5", "_", "_", "W", "_", "W"],
    ["W", "_", "_", "_", "_", "_", "_", "_", "_", "W"],
    ["W", "_", "_", "W", "_", "3", "_", "_", "_", "W"],
    ["W", "_", "_", "_", "_", "_", "_", "2", "_", "W"],
    ["G", "D", "G", "_", "_", "_", "_", "_", "_", "W"],
    ["W", "_", "G", "_", "4", "_", "3", "_", "_", "W"],
    ["W", "E", "G", "_", "_", "_", "_", "_", "_", "W"],
    ["W", "W", "W", "W", "W", "W", "W", "W", "W", "W"]
  ],
  "player_start": [1.5, 5],
  "inventory": ["Pistol", "Shotgun", "Machine Gun", "Plasma Gun"],
  "starting_ammo": {
    "Pistol": 30,
    "Shotgun": 10,
    "Machine Gun": 50,
    "Plasma Gun": 20
  }
}