{
  "map": [
    ["1", "1", "1", "1", "1", "1", "1", "1", "1", "1"],
    ["1", "/", "_", "/", "_", "_", "/", "_", "/", "1"],
    ["1", "/", "_", "_", "_", "_", "_", "_", "/", "1"],
    ["1", "/", "/", "_", "/", "/", "_", "/", "/", "1"],
    ["1", "/", "_", "_", "_", "_", "_", "_", "/", "1"],
    ["1", "/", "_", "/", "_", "_", "/", "_", "/", "1"],
    ["1", "/", "_", "_", "_", "_", "_", "_", "/", "1"],
    ["1", "/", "/", "_", "/", "/", "_", "_", "/", "1"],
    ["1", "/", "_", "_", "_", "_", "_", "/", "/", "1"],
    ["1", "/", "_", "_", "_", "_", "_", "_", "/", "1"],
    ["1", "/", "_", "_", "_", "_", "_", "_", "/", "1"],
    ["1", "/", "_", "_", "_", "_", "_", "_", "/", "1"],
    ["1", "/", "_", "_", "_", "_", "_", "_", "/", "1"],
    ["1", "/", "_", "_", "_", "_", "_", "_", "/", "1"],
    ["1", "/", "_", "_", "_", "_", "_", "_", "/", "1"],
    ["1", "/", "_", "_", "_", "_", "_", "_", "/", "1"],
    ["1", "/", "_", "_", "_", "_", "_", "_", "/", "1"],
    ["1", "/", "_", "_", "_", "_", "_", "_", "/", "1"],
    ["1", "/", "_", "_", "_", "_", "_", "_", "/", "1"],
    ["1", "1", "1", "1", "1", "1", "1", "1", "1", "1"]
  ],
  "player_start": [4.5, 18.5],
  "inventory": ["Shotgun"],
  "starting_ammo": {
    "Shotgun": 20
  },
    "background": {
    "ceiling_texture": "resources/textures/ceiling.png",
    "floor_texture": "resources/textures/forest_floor.png",
    "ceiling_color": null,
    "floor_color": null
  },
  "doors": [],
  "exit": [16, 14]
}
